40 33
00 00 00 00 00 00 00 00 00 00 00 00 00 00 00 00 00 00 00 00 00 00 00 00 00 00 00 00 00 00 00 00 00 00 00 00 00 00 00 00
00 00 00 00 00 00 00 00 00 00 00 00 00 00 00 00 00 00 00 00 00 00 00 00 00 00 00 00 00 00 00 00 00 -3 00 00 00 00 00 00
00 00 00 00 00 00 00 00 00 00 00 00 00 00 -2 00 00 00 00 00 00 00 00 00 00 00 00 00 00 00 00 00 11 11 11 00 00 00 00 00
00 00 00 00 00 00 00 00 00 00 00 00 11 11 11 11 11 00 00 00 00 00 00 00 00 00 -2 00 00 00 00 00 00 00 00 00 00 00 00 00
00 00 00 00 00 00 -2 00 00 00 00 00 00 00 00 00 00 00 00 00 00 00 00 00 11 11 11 11 11 00 00 00 00 00 00 00 00 00 00 00
00 00 00 00 11 11 11 11 11 00 00 00 00 00 00 00 00 00 00 00 00 00 00 00 00 00 00 00 00 00 00 00 00 00 00 00 00 00 00 00
00 00 00 00 00 00 00 00 00 00 00 00 00 00 00 00 00 00 00 00 00 00 00 00 00 00 00 00 00 00 00 00 00 00 00 00 00 00 00 00
00 00 00 00 00 00 00 00 00 00 00 00 00 00 00 00 00 00 00 -3 00 00 00 00 00 00 00 00 00 00 00 00 00 00 00 00 00 00 00 00
00 -3 00 00 00 00 00 00 00 00 00 00 00 00 00 00 00 00 11 11 11 00 00 00 00 00 00 00 00 00 00 00 -2 00 00 00 00 00 00 00
00 11 11 11 00 00 00 00 00 00 00 -2 00 00 00 00 00 00 00 00 00 00 00 00 00 00 00 00 00 00 11 11 11 11 11 00 00 00 00 00
00 00 00 00 00 00 00 00 00 11 11 11 11 11 00 00 00 00 00 00 00 00 00 00 00 00 00 00 00 00 00 00 00 00 00 00 00 00 00 00
00 00 00 00 00 00 00 00 00 00 00 00 00 00 00 00 00 00 00 00 00 00 00 00 00 -2 00 00 00 00 00 00 00 00 00 00 00 00 -3 00
00 00 00 00 00 -3 00 00 00 00 00 00 00 00 00 00 00 00 00 00 00 00 00 11 11 11 11 11 00 00 00 00 00 00 00 00 00 11 11 00
00 00 00 00 11 11 11 00 00 00 00 00 00 00 00 00 00 00 00 00 00 00 00 00 00 00 00 00 00 00 00 00 00 00 00 00 00 00 00 00
00 00 00 00 00 00 00 00 00 00 00 00 00 00 00 00 00 00 00 00 00 00 00 00 00 00 00 00 00 00 00 00 00 00 00 00 00 00 00 00
00 00 00 00 00 00 00 00 00 00 00 00 00 00 00 00 00 00 00 -3 00 00 00 00 00 00 00 00 00 00 00 -2 00 00 00 00 00 00 00 00
00 00 -3 00 00 00 00 00 00 00 00 00 00 00 00 00 00 00 11 11 11 00 00 00 00 00 00 00 00 11 11 11 11 11 00 00 00 00 00 00
00 11 11 11 00 00 00 00 00 00 00 00 -3 00 00 00 00 00 00 00 00 00 00 00 00 00 00 00 00 00 00 00 00 00 00 00 00 00 00 00
00 00 00 00 00 00 00 00 00 00 00 11 11 11 11 00 00 00 00 00 00 00 00 00 00 00 00 00 00 00 00 00 00 00 00 00 00 00 00 00
00 00 00 00 00 00 00 00 00 00 00 00 00 00 00 00 00 00 00 00 00 00 00 00 -3 00 00 00 00 00 00 00 00 00 00 00 00 00 -3 00
00 00 00 00 00 00 00 00 00 00 00 00 00 00 00 00 00 00 00 00 00 00 00 11 11 11 00 00 00 00 00 00 00 00 00 00 00 11 11 00
00 00 00 00 00 00 -2 00 00 00 00 00 00 00 00 00 00 00 00 00 00 00 00 00 00 00 00 00 00 00 00 00 00 00 00 00 00 00 00 00
00 00 00 00 11 11 11 11 11 11 00 00 00 00 00 00 00 00 00 00 00 00 00 00 00 00 00 00 00 00 00 00 00 00 00 00 00 00 00 00
00 00 00 00 00 00 00 00 00 00 00 00 00 00 00 00 00 00 -2 00 00 00 00 00 00 00 00 00 -3 00 00 00 00 00 00 00 00 00 00 00
00 00 00 00 00 00 00 00 00 00 00 00 00 00 00 00 11 11 11 11 11 11 00 00 00 00 00 11 11 11 00 00 00 00 00 00 00 00 00 00
00 00 -3 00 00 00 00 00 00 00 00 00 00 00 00 00 00 00 00 00 00 00 00 00 00 00 00 00 00 00 00 00 00 00 00 00 00 00 00 00
00 00 11 11 00 00 00 00 00 00 00 00 00 00 00 00 00 00 00 00 00 00 00 00 00 00 00 00 00 00 00 00 00 00 00 00 00 00 00 00
00 00 00 00 00 00 00 00 00 00 00 00 00 00 00 00 00 00 00 00 00 00 00 00 00 00 00 00 00 00 00 00 00 00 00 00 00 -3 00 00
00 00 00 00 00 -3 00 00 00 00 00 00 00 00 -3 00 00 00 00 00 00 00 00 -2 00 00 00 00 00 00 -3 00 00 00 00 00 11 11 11 00
00 00 00 00 11 11 11 00 00 00 00 00 00 11 11 11 00 00 00 00 00 11 11 11 11 11 11 00 00 11 11 11 00 00 00 00 00 00 00 00
00 00 00 00 00 00 00 00 00 00 00 00 00 00 00 00 00 00 00 00 00 00 00 00 00 00 00 00 00 00 00 00 00 00 00 00 00 00 00 00
00 -1 00 00 00 00 00 00 00 00 00 00 00 00 00 00 00 00 00 00 00 00 00 00 00 00 00 00 00 00 00 00 00 00 00 00 00 00 00 00
11 11 11 11 11 11 11 11 11 11 11 11 11 11 11 11 11 11 11 11 11 11 11 11 11 11 11 11 11 11 11 11 11 11 11 11 11 11 11 11
